###########
#  @ ######
###$$######
#    .    #
#   $     #
##.       #
##.       #
###########