#######
##  ###
##$   #
##@$. #
# $#.##
#   .##
#    ##
#    ##
#######