#######
##  ###
##$   #
##@$. #
#   .##
#    ##
#  $ ##
#   .##
#######