############
###  #######
#@ .$#######
#   $     .#
# # $  #####
#      #  .#
#          #
#          #
############