##########
#.       #
#        #
#     #  #
#     # .#
#     ####
#$  $    #
#        #
#       @#
##########