#######
###@ ##
###$$##
#    .#
#   $ #
##. ###
##. ###
#######