##########
#        #
#  $ @ $ #
#    $$  #
#  .. .. #
##########